%%%%%%%%%%%%%%%%%%%%
%o...%...J....%....%
%.%%.%.%%%%%%.%.%%.%
%.%..............%.%
%.%.%%.%%  %%.%%.%.%
%......%.  G%......%
%.%.%%.%%%%%%.%%.%.%
%G%..............%.%
%.%%.%.%%%%%%.%.%%.%
%....%...P....%..G.%
%%%%%%%%%%%%%%%%%%%%