%%%%%%%%%%%%%%%%%%%%
%G...%...J....%....%
%.%%.%.%%%%%%.%.%%.%
%.%..............%.%
%.%.%%.%%  %%.%%.%.%
%......%.  G%......%
%.%.%%.%%%%%%.%%.%.%
%.%..............%.%
%.%%.%.%%%%%%.%.%%.%
%J...%...P....%...G%
%%%%%%%%%%%%%%%%%%%%