%%%%%%%%%%%%%%%%%%%%
%....%...J....%....%
%.%%.%.%%%%%%.%.%%.%
%.%..............%.%
%.%.%%.%%  %%.%%.%.%
%......%.  G%......%
%.%.%%.%%%%%%.%%.%.%
%.%..............%.%
%.%%.%.%%%%%%.%.%%.%
%....%...P....%....%
%%%%%%%%%%%%%%%%%%%%