%%%%%%%%%%%%%%%%%%%%
%.................G%
%..................%
%..................%
%..................%
%..................%
%..................%
%..................%
%..................%
%P.................%
%%%%%%%%%%%%%%%%%%%%