%%%%%%%%%%%%%%%%%%%%
%G................J%
%..................%
%..................%
%..................%
%..................%
%..................%
%..................%
%..................%
%P................G%
%%%%%%%%%%%%%%%%%%%%