%%%%%%%%%%%%%%%%%%%%
%                 P%
%.%%%%%%%%%%%%%%%%%%
%                  %
%%%%%%%%%%%%%%%%%%.%
%..................%
%.%%%%%%%%%%%%%%%%%%
%..................%
%..................%
%G........J.......G%
%%%%%%%%%%%%%%%%%%%%