%%%%%%%%%%%%%%%%%%%%
%                 P%
%.%%%%%%%%%%%%%%%%%%
%                  %
%%%%%%%%%%%%%%%%%%.%
%..................%
%.%%%%%%%%%%%%%%%%%%
%....G........G....%
%..................%
%G.....J..J..J....G%
%%%%%%%%%%%%%%%%%%%%