%%%%%%%%%%%%%%%%%%%%
%                  %
%   %%%%%%%%%%%%   %
%   %J        J%   %
%   %  %    %  %   %
%   %  %    %  %   %
%   %  %    %  %   %
%   %  %    %  %   %
%   %G %%%%%% G%   %
%P                 %
%%%%%%%%%%%%%%%%%%%%