%%%%%%%%%%%%%%%%%%%%
%...%..........%...%
%..%%.%......%.%%..%
%.%%...%....%...%%.%
%.......%..%.......%
%%.%.%.%....%.%.%.%%
%.........J........%
%.%%.%%%....%%%.%%.%
%..%%..........%%..%
%..P%..........%..G%
%%%%%%%%%%%%%%%%%%%%